11x14
***********O**
*R  ++*R     *
* R        R *
*   H    ++***
*  **      R *
*   R*+***   *
***    R     *
*  **        O  
*  R  +++++  *
*         R  *
*****O********