8x9
O********
*R  ***R*
* R  ++ *
*   H   *
*  +*   O
*   R   *
*+*    R*
***+*****